Null
XXXXXXXXXX
X00000000X
X0FFFFFF0X
X0FFFFFF0X
X0FPFFSF0X
X0FFFFFF0X
X0XFFFFX0X
X0XFFFFX0X
X00000000X
XXXXXXXXXX