Hey KokSucker, you see that block over there,\I'm gonna need you to push it!\\\\\Sincerely,\  -DeezNuts
XXXX00XXXXXXXXXXXXXX
XFF0F0000X0X0000000X
XFFF0B000XXX000X000X
X0F0000X00PS00X0X00X
XFF000XXX00XX00X000X
XF0BB00X00VB0000BT0X
XFX0B00000TH000B0T0X
XFFF000000000000000X
XXXXXX0B0XXXXXXXXXXX