Insert Message Here\Line2\Line3
XXXXXXXXXXXXXXXXXXXX
X0000000000FFFFFXXXX
X000000000000FFXXXXX
X00000000000XXXX00FX
X00000000000B000TFFX
X00000000000XXXXFFFX
X00000000000FF0XXXXX
X0000000000FFFFFXXXX
X00000000FFFXXXXXXXX
XXXXXXXXXXXXXXXXXXXX
