Aw shit, I left all my crap in the way!\\Listen, these boxes are fucked,\you can only push them in one axis.\\\Whoever designed these boxes sucks DICK!
XXXXXXXXXXXXXXXXXXX
XXXFFX0XXCXX0XXXXXX
XXFZAX0XX0XX0XZZCXX
XX00ZX0XXVXXVX00ZZX
XZFHFFVFFVF0VFFFTZX
XZF00XVXX0XXVX00ZZX
XZF000V0000000000FX
XZF0S0ZaaZZaaa0P0FX
XCFFFFFFAZAFFFFFFFX
XXXXXZZFFFFFFFCXXXX
XXXXXXXXXXXXXXXXXXX
