So don't get mad, but I dropped some arrows\that force you to go one direction.\\Normally I'd clean this up myself,\but I've got to pick up my kid\from soccer practice.\\Can you remind me later?\Thanks Bruh
XXXXXXXXXXXXXXXXXXXXXX
XFFZFFFFFFFFXXXXZZXXXX
XFAZZS00BFBFXXXZZZZZZX
XFPZZZF0000FXXXZAaaaXX
XZZFFFFFF000XXXXXXXXXX
XXXXXXXXX222XXXXXXXXXX
XXXXXXXXX222XXXZAFFZXX
XXXXXXXXX000440ZZZFFFX
XZZZZXXXXF0044ZZZTTFFX
XZZCZZZXXFF044ZZFFFFFX
XZCCCCZXXFFFXXXXXXXXXX
XXXXXXXXXXXXXXXXXXXXXX
