Aw shit, I left all my crap in the way!\\Listen, these boxes are fucked,\you can only push them in one axis.\\\Whoever designed these boxes sucks DICK!
XXXXXXXXXXXXXXXXXXX
XXXFFX0XX0XX0XXXXXX
XXF00X0XX0XX0X000XX
XX000X0XXVXXVX0000X
X0FHFFVFFVF0VFFFT0X
X0F00XVXX0XXVX0000X
X0F000V0000000000FX
X0F0S000CZ00000P0FX
X0FFFFFF000FFFFFFFX
XXXXX00FFFFFFF0XXXX
XXXXXXXXXXXXXXXXXXX
