HOLY CRAP BALLZ! THAT WAS AMAZING!\\Do you think you could do the same with\two of them?\\btw, press 'Z' to reverse your mistakes\\Sincerely,\  -DeezNuts
XXXXXXXXXXXXXXXXX
XFZZZAZZ0XFFFXXXX
XFPZSZZ0BXFF0CXXX
XFFFFZZX0X0000XXX
XZZZF0Z00000000ZX
XXXZF00XXX00TT0ZX
XXXFFFBFFFFF00ZAX
XXXXXXXXXXXFFFFXX
XXXXXXXXXXXXXXXXX
