Hey KokSuker, you see that block over there,\I'm gonna need you to push it!\\\\\Sincerely,\  -DeezNuts
XXXXXXXXXXXXXXXXXXXX
XXXXXXFF000FFFFFXXXX
XXXFFFF000000FFXXXXX
XXXF00000000XXXX00FX
XFFF00S0FFFFB000T0FX
XFF000FFFF00XXXX0FFX
XFP000FF00000FFXXXXX
XFFFFFFF000FFFFFXXXX
XXXXXXX00FFFXXXXXXXX
XXXXXXXXXXXXXXXXXXXX
