Hey KokSuker, you see that block over there,\I'm gonna need you to push it!\\\\\Sincerely,\  -DeezNuts
XXXXXXXXXXXXXXXXXXXX
XXXXXXFFaaaFFFFFXXXX
XXXFFFFZZZZZ0FFXXXXX
XXXFZZZZ0000XXXX00FX
XFFFZZS0FFFFB000T0FX
XFFZZ0FFFF00XXXX0FFX
XFP000FF00000FFXXXXX
XFFFFFFFZZZFFFFFXXXX
XXXXXXXZAFFFXXXXXXXX
XXXXXXXXXXXXXXXXXXXX
