HOLY CRAP BALLZ! THAT WAS AMAZING!\\Do you think you could do the same with\two of them?\\btw, press 'Z' to reverse your mistakes\\Sincerely,\  -DeezNuts
XXXXXXXXXXXXXXXXX
XF0000000XFFFXXXX
XFP0S000BXFF00XXX
XFFFF00X0X0000XXX
X000F00000000000X
XXX0F00XXX00TT00X
XXXFFFBFFFFF0000X
XXXXXXXXXXXFFFFXX
XXXXXXXXXXXXXXXXX
