XXXX00XXXXXXXXXXXXXX
XFF0F0000X0X0000000X
XFFF0B000XXX000X000X
X0F0000X000000X0X00X
XFF000XXX00XX00X000X
XF0BB00X00000000BT0X
XFX0B00000000P0B0T0X
XFFF000000000000000X
XXXXXX0B0XXXXXXXXXXX
