XXXXXXXXXX
X00000000X
X0FFFFFF0X
X0FFFFFF0X
X0F0FF0F0X
X0FFFFFF0X
X0XFFFFX0X
X0XFFFFX0X
X00000000X
XXXXXXXXXX